###################################################
S #       #           #   #       #     #   #     #
# # ##### # ######### ### # ##### # ### # # ### # #
# #     #   #       #   #   #   #     # # #     # #
# ##  # ### # ##### ### ##### # ##### # # ### ### #
#     #     #     #   #     # #     # #   #   #   #
### # ############### ##### # ##### # ##### ##### #
### #     #     #         # #   #   # #   #     # #
### # ##### # # # ##### ### ### # ### # # ### # ###
### #     # # # # #     #   #   #   # # #   # #   #
### # ### # # # # ####### ### ##### ### ### # ### #
### #   #   # # #       #     #   #   # #   # # # #
### ### ####### # ##### ####### ##### # ### # # # #
#   #     #     #     #               # #   #   # #
# ### ##### ######### ################# # ####### #
#   # # #   #     #   #   #     #       #       # #
### # # # ### # # # ### ### ### # # ########### # #
#   # # # #   # # # #         # # #   #   #     # #
# ### # # # ##### # ########### # ### # ### ##### #
#   #   #   #   # #           # # #   #   # #     #
### ####### # # # ########### # # # ### # # # #####
# #   #     # # # #             # #   # #   #     #
# ### # # ### # # ############# ##### ##### ### # #
#     # # #   # #   #         #       #   #     # #
# ##### ### # ##### # ####### ######### # ##### ###
#   # #   # # #     #   # #   # #     # #     #   #
### # ### ### # ##### # # # ### # # # # # ### ### #
#   # #     # #     # # # # #     # # # # #     # #
### # # ### # ##### ### # # ####### # # # ####### #
#   #     #       # #   # #       # # # #       # #
# ################# # # # ####### # ### ####### # #
#       #         #   #   #       #     #     #   #
####### # ####### ############# ### ##### # #######
#     # # #     # #   #       # # #   #   #     # #
# ### # # # ### # # # # ##### # # ### # # ##### # #
#   # # # # # #   # #   # #   # # #   # #     #   #
### # # # # # ##### ##### # ### # # ######### #####
# # # #   # #   #   #     # #   #   #       #     #
# # # ##### ### # ### ### # # ### ### # ### # ### #
#   #     # #     #   #   #   #   # # #   # #   # #
# ####### # # ##### ########### ### # ### # ##### #
# # #     #   #     #       # #   #   #   #   #   #
# # # ######### ##### ### # # ### ##### ##### # # #
# # # #       #       #   # #   #   #   #     # # #
# # # # ##### # ####### ### ### ### # ### ##### # #
#   # # #   #   # #     #         #   # #       # #
### # # # # ##### # ################### ### ##### #
# # # # # # #     #   #         #     #   #   #   #
# # # # # # # ### ### # ##### ### ### # ##### # ###
#   #     #     #   #       #       #         #   E
###################################################
